+---------+
|       21|
|    ^    |
|   / \   |
|  /___\  |
| /\===/\ |
|/  \=/  \|
|____v____|
+---------+
